1111111111111111111111
1000100000000000000001
1000100000000000000001
1000100000000000000001
1000100000000000000001
1000100000000000000001
1000100000010000000001
1000100000010000000001
1000000000010000000001
1000000000010000000001
100000000001000N000001
1000000000010000000001
1000000000010000000001
1000000000000000000001
1000000000000000000001
1111111111111111111111
