NO ./assets/wall1.xpm42
SO ./assets/wall2.xpm42
WE ./assets/wall3.xpm42
EA ./assets/wall4.xpm42

F 220,100,0
C 225,30,0

1111111111111111111111
1000100000000000000001
1000100000000000000001
1000100000111111111111
1000100000000000000001
1000100000000000000001
1000100000010000000001
1000100000010000000001
1000000000010000111111
1000000000010000000001
100000000001000N000001
1000000000010000000001
1111111111110010000001
1000000000000010000001
1000000000000010000001
1111111111111111111111
