NO ./assets/wall1.xpm42
SO ./assets/wall2.xpm42
WE ./assets/wall3.xpm42
EA ./assets/wall4.xpm42

F 220,100,0
C 225,30,0

        1111111111111111111111111
        1000000000110000000000H01
        1011000001110000C00000001
        10010000000E0000000000001
111111111011000001110000000000H01
100000000011000001110111111111111
11110111111111011100000010001
11110111111111011101010010001
11000000110101011100000000001
10000000000000001100000010001
10000000000000001101010010001
1100000111010101111101111000111
11110111 1110101 101111010001
11111111 1111111 111111111111
