11111111111111111111111
10000000100010000000001
10101111101110111111111
10100000000000001000001
10101011111110101011101
10101000000010100000101
10101011111111111111111
10101000000000000000001
10101110101010101011111
10100010101010101000001
10101010111111101110111
10101010000000100010001
10101110111110101110101
10100010000010100010101
10101110111010101010111
10101000001010101010001
10101110101111111111101
10101000101010000000101
10101010101010111110101
10101010100000000010101
10101010111110111111101
101010100000100000001N1
11111111111111111111111
