
   NO ok.xpm42


SO 2.xpm42


WE 3.xpm42
EA 4.xpm42

C 255,200,200
F 100,100,100

111111111
100000001
100000001
111111111