NO ./assets/wall2.xpm42
SO ./assets/wall2.xpm42
WE ./assets/wall3.xpm42

EA ./assets/wall4.xpm42

F 128,0,0
C 180,10,0

111111111
1000000C1
1E0000C01
111111111
