
      NO         ok.xpm42 

SO 2.xpm42

WE 3.xpm42         
EA 4.xpm42


C 255,000,120

F 100,100,100

11111
10S01
10001
10001
11111