NO ./assets/wall2.xpm42
SO ./assets/wall2.xpm42
WE ./assets/wall3.xpm42

EA ./assets/wall4.xpm42

F 220,100,0
C 225,30,0

11111111111111111111111
10N00010000000000000001
11111111111111111111111
