

adsasd
adsasd

adsasd

11jjjj1111
100101
100001
100001
1100N1
111111
