NO ./assets/wall2.xpm42
SO ./assets/wall2.xpm42
WE ./assets/wall3.xpm42

EA ./assets/wall4.xpm42

F 220,100,0
C 225,30,0

111111111
1N1
111111111