
      NO         ok.xpm42 

SO 2.xpm42

WE 3.xpm42         
EA 4.xpm42


C 255,000,120

F 100,100,100

1
11
101
11
1111
10S1
1001
1001
1001
1001
1111
