NO ./assets/1.xpm42
SO ./assets/2.xpm42
WE ./assets/3.xpm42
EA ./assets/4.xpm42

F 255,0,0
C 180,10,0

111111111
10000X001
100000001
100H000C1
100000001
100000C01
1E0010001
111111111
