
      NO         ok.xpm42 

SO 2.xpm42

WE 3.xpm42
EA 4.xpm42

C     255,000,2
F 100,100,100

11111
1
1
111P11111
100X00001
100000001
111111111