NO ./assets/wall2.xpm42
SO ./assets/wall2.xpm42
WE ./assets/wall3.xpm42
EA ./assets/wall4.xpm42

F 220,100,0
C 225,30,0

1
11
101
11
1111
10S1
1001
1001
1001
1001
1111
